#######............................#
#.S......###############.....#.....#
#.#...#.........#............#.....#
..###.#.........#####.#..#####.....#
#.#...########...#....#....#.#.....#
#.#.#........##..#...###...........#
#.#.#.######..#.######...######....#
..#.#.#.#..####....##..#..#...#....#
#.#...#.#.#.....####...#..#.....####
..##..#.#.#####..#....#####.........
#..##...#.#......##..#.......#..#.#.
#.#####.#.######.....#...#####..#.#.
#..............#.....#.....X.#..#.#.
###########.##.########.....#####.##